region_code,region_name,dept_code,dept_name,registered_voters,absent_voters,present_voters,blank_ballot,null_ballot,votes_cast,LE PEN,MACRON
84,Auvergne-Rhône-Alpes,01,Ain,415950,93130,322820,28852,8738,285230,111421,173809
32,Hauts-de-France,02,Aisne,375791,90745,285046,22838,9067,253141,133939,119202
84,Auvergne-Rhône-Alpes,03,Allier,253479,59294,194185,18877,8522,166786,60207,106579
93,Provence-Alpes-Côte d'Azur,04,Alpes-de-Haute-Provence,126459,29255,97204,9671,3722,83811,34817,48994
93,Provence-Alpes-Côte d'Azur,05,Hautes-Alpes,109892,24895,84997,8670,2699,73628,26417,47211
93,Provence-Alpes-Côte d'Azur,06,Alpes-Maritimes,761780,198631,563149,47784,12414,502951,224544,278407
84,Auvergne-Rhône-Alpes,07,Ardèche,249216,54487,194729,19800,7221,167708,63109,104599
44,Grand Est,08,Ardennes,194349,49886,144463,12787,4681,126995,62571,64424
76,Occitanie,09,Ariège,117406,26698,90708,10133,4518,76057,28074,47983
44,Grand Est,10,Aube,203800,45670,158130,13662,4478,139990,64180,75810
76,Occitanie,11,Aude,272643,61830,210813,20177,8283,182353,81452,100901
76,Occitanie,12,Aveyron,218097,43851,174246,16715,7353,150178,40838,109340
93,Provence-Alpes-Côte d'Azur,13,Bouches-du-Rhône,1370057,364020,1006037,81938,26308,897791,378456,519335
28,Normandie,14,Calvados,501062,109700,391362,32129,12616,346617,114002,232615
84,Auvergne-Rhône-Alpes,15,Cantal,117394,25279,92115,9039,3727,79349,23938,55411
75,Nouvelle-Aquitaine,16,Charente,259951,60540,199411,17707,8088,173616,59916,113700
75,Nouvelle-Aquitaine,17,Charente-Maritime,491298,111824,379474,34720,12435,332319,116854,215465
24,Centre-Val de Loire,18,Cher,228984,58021,170963,18098,5131,147734,57358,90376
75,Nouvelle-Aquitaine,19,Corrèze,185245,38160,147085,15135,7966,123984,35955,88029
27,Bourgogne-Franche-Comté,21,Côte-d'Or,360646,77255,283391,26652,7973,248766,89121,159645
53,Bretagne,22,Côtes-d'Armor,455840,87670,368170,32887,12776,322507,85554,236953
75,Nouvelle-Aquitaine,23,Creuse,93122,21738,71384,7806,3911,59667,20428,39239
75,Nouvelle-Aquitaine,24,Dordogne,313901,65757,248144,25155,12121,210868,75335,135533
27,Bourgogne-Franche-Comté,25,Doubs,368314,84624,283690,26079,9372,248239,89935,158304
84,Auvergne-Rhône-Alpes,26,Drôme,369462,82109,287353,26411,8638,252304,94312,157992
28,Normandie,27,Eure,427522,97296,330226,29221,8730,292275,133417,158858
24,Centre-Val de Loire,28,Eure-et-Loir,301455,71216,230239,20669,6454,203116,80696,122420
53,Bretagne,29,Finistère,690439,144538,545901,51327,14352,480222,108890,371332
94,Corse,2A,Corse-du-Sud,108760,38512,70248,5638,3056,61554,30415,31139
94,Corse,2B,Haute-Corse,124873,45639,79234,6899,4088,68247,32567,35680
76,Occitanie,30,Gard,537840,130425,407415,37436,13865,356114,161125,194989
76,Occitanie,31,Haute-Garonne,906832,220547,686285,60572,22453,603260,166595,436665
76,Occitanie,32,Gers,144950,27635,117315,11574,4746,100995,33424,67571
75,Nouvelle-Aquitaine,33,Gironde,1086565,251825,834740,73193,25795,735752,220261,515491
76,Occitanie,34,Hérault,800264,197629,602635,55367,19702,527566,215147,312419
53,Bretagne,35,Ille-et-Vilaine,730055,148868,581187,46034,15864,519289,115942,403347
24,Centre-Val de Loire,36,Indre,170405,39911,130494,12640,6054,111800,43627,68173
24,Centre-Val de Loire,37,Indre-et-Loire,428840,98512,330328,29855,9824,290649,89438,201211
84,Auvergne-Rhône-Alpes,38,Isère,856330,202643,653687,56622,14771,582294,199097,383197
27,Bourgogne-Franche-Comté,39,Jura,190316,41062,149254,15361,4737,129156,49888,79268
75,Nouvelle-Aquitaine,40,Landes,310122,62813,247309,24690,9339,213280,66661,146619
24,Centre-Val de Loire,41,Loir-et-Cher,245294,54567,190727,17948,6094,166685,65896,100789
84,Auvergne-Rhône-Alpes,42,Loire,510903,123362,387541,34501,10723,342317,123714,218603
84,Auvergne-Rhône-Alpes,43,Haute-Loire,177116,37641,139475,14104,5026,120345,44112,76233
52,Pays de la Loire,44,Loire-Atlantique,993413,214740,778673,69975,28145,680553,155353,525200
24,Centre-Val de Loire,45,Loiret,452621,103643,348978,30731,9508,308739,113735,195004
76,Occitanie,46,Lot,136265,27297,108968,11454,4775,92739,25802,66937
75,Nouvelle-Aquitaine,47,Lot-et-Garonne,240882,52263,188619,17019,7789,163811,66393,97418
76,Occitanie,48,Lozère,59496,11884,47612,5008,2335,40269,13275,26994
52,Pays de la Loire,49,Maine-et-Loire,569235,121568,447667,38496,12573,396598,107781,288817
28,Normandie,50,Manche,379038,82803,296235,25189,8256,262790,86126,176664
44,Grand Est,51,Marne,381657,95150,286507,24483,7957,254067,109227,144840
44,Grand Est,52,Haute-Marne,134119,32081,102038,9095,3420,89523,44331,45192
52,Pays de la Loire,53,Mayenne,222338,46235,176103,14820,5510,155773,43581,112192
44,Grand Est,54,Meurthe-et-Moselle,495086,124859,370227,32546,10029,327652,128902,198750
44,Grand Est,55,Meuse,137552,31478,106074,9414,3090,93570,45267,48303
53,Bretagne,56,Morbihan,576899,117229,459670,41362,13638,404670,115076,289594
44,Grand Est,57,Moselle,751246,201732,549514,46637,12563,490314,207597,282717
27,Bourgogne-Franche-Comté,58,Nièvre,159382,38170,121212,12103,4441,104668,41946,62722
32,Hauts-de-France,59,Nord,1804404,482933,1321471,104014,40217,1177240,507434,669806
32,Hauts-de-France,60,Oise,561950,133699,428251,36747,11446,380058,177549,202509
28,Normandie,61,Orne,208691,45577,163114,14762,4798,143554,55070,88484
32,Hauts-de-France,62,Pas-de-Calais,1090441,262219,828222,62533,30349,735340,382782,352558
84,Auvergne-Rhône-Alpes,63,Puy-de-Dôme,460919,105034,355885,34639,13654,307592,88155,219437
75,Nouvelle-Aquitaine,64,Pyrénées-Atlantiques,502323,110333,391990,38518,14478,338994,85377,253617
76,Occitanie,65,Hautes-Pyrénées,177678,40662,137016,14172,5825,117019,37225,79794
76,Occitanie,66,Pyrénées-Orientales,347864,86711,261153,23579,13056,224518,105874,118644
44,Grand Est,67,Bas-Rhin,766650,183249,583401,44707,13965,524729,193788,330941
44,Grand Est,68,Haut-Rhin,526161,128800,397361,36854,9309,351198,147599,203599
84,Auvergne-Rhône-Alpes,69,Rhône,1155506,289848,865658,69066,19260,777332,205317,572015
27,Bourgogne-Franche-Comté,70,Haute-Saône,179187,37287,141900,11666,7352,122882,59341,63541
27,Bourgogne-Franche-Comté,71,Saône-et-Loire,406311,94636,311675,30144,10661,270870,103925,166945
52,Pays de la Loire,72,Sarthe,405623,94499,311124,33558,8890,268676,98523,170153
84,Auvergne-Rhône-Alpes,73,Savoie,310179,72291,237888,22324,6848,208716,73598,135118
84,Auvergne-Rhône-Alpes,74,Haute-Savoie,538007,127636,410371,37350,10077,362944,113746,249198
11,Île-de-France,75,Paris,1301537,279898,1021639,57868,16744,947027,97770,849257
28,Normandie,76,Seine-Maritime,880756,211393,669363,64519,16546,588298,232857,355441
11,Île-de-France,77,Seine-et-Marne,880940,228009,652931,58538,15410,578983,209221,369762
11,Île-de-France,78,Yvelines,950821,225177,725644,57527,15318,652799,149138,503661
75,Nouvelle-Aquitaine,79,Deux-Sèvres,272387,57585,214802,18203,6733,189866,54039,135827
32,Hauts-de-France,80,Somme,408957,90588,318369,25978,9600,282791,129465,153326
76,Occitanie,81,Tarn,291153,62264,228889,20888,10554,197447,71856,125591
76,Occitanie,82,Tarn-et-Garonne,183329,39522,143807,12693,5960,125154,53166,71988
93,Provence-Alpes-Côte d'Azur,83,Var,794665,202023,592642,52879,15270,524493,257769,266724
93,Provence-Alpes-Côte d'Azur,84,Vaucluse,402307,94108,308199,26871,8250,273078,127113,145965
52,Pays de la Loire,85,Vendée,514425,103148,411277,33739,14589,362949,109035,253914
75,Nouvelle-Aquitaine,86,Vienne,306977,68711,238266,20858,8441,208967,65255,143712
75,Nouvelle-Aquitaine,87,Haute-Vienne,266309,57292,209017,19958,10878,178181,51763,126418
44,Grand Est,88,Vosges,282532,63279,219253,19215,8068,191970,85894,106076
27,Bourgogne-Franche-Comté,89,Yonne,241891,56989,184902,16813,6499,161590,72651,88939
27,Bourgogne-Franche-Comté,90,Territoire de Belfort,95258,23179,72079,6777,2829,62473,26128,36345
11,Île-de-France,91,Essonne,795235,199441,595794,50347,15288,530159,147509,382650
11,Île-de-France,92,Hauts-de-Seine,983522,226846,756676,57359,9322,689995,99032,590963
11,Île-de-France,93,Seine-Saint-Denis,766977,249213,517764,38645,12471,466648,98825,367823
11,Île-de-France,94,Val-de-Marne,785586,207455,578131,43777,12536,521818,102673,419145
11,Île-de-France,95,Val-d'Oise,730335,204202,526133,42933,11664,471536,129518,342018
